1111111111111111111111111111
1P111C00100010101101C00001E1
101110101C100010C10101010101
1C11100C00001C100C01010101C1
1011101010111000100101010101
100000101C111010110C00010001
1111111111111111111111111111