11111111111111111
110C0C1C0C0C1C0E1
11C1C0C0C1C0C0C11
100000PCCCC000001
11111000010001111
10000011110110001
11111111111111111