1111111111111111111
1P00000000000000001
1000000000000000001
1000000000000000001
1000000000000000001
1000000000000000001
1000000000C00000001
1000000000000000C01
10000000000000000E1
1111111111111111111