11111111111111111111
1000000C0000000000P1
1011101110111C111101
100C00111000C1C00001
1C10111110111C111101
101000C0001110111101
10111011111110111101
10111011000000111101
101110CC011110000001
10000000000000111101
10111111C11111111101
1C1111110111111111C1
11C0000000000C000011
1C111011101111111101
100110111011101111C1
11000011101100011101
1C111111101110111101
10111111101111111101
100000000C00000000E1
11111111111111111111